1time - 1T0
9g-rail-ltd - 9G
ac-challenge-aero - 5U
accesrail - 9B
acg-air-cargo-germany - 6U
adria-airways - JP
aegean-airlines - A3
aer-arann - RE
aer-lingus - EI
aero-airlines - EE
aero-regional-paraguaya - P7
aerocontractors - AJ
aeroflot - SU
aerolinea-principal-chile - 5P
aerolineas-argentinas - AR
aerolineas-del-sur - 3I
aerolineas-galapagos - 2K
aerolineas-mas - N3
aeromar - VW
aeromexico - AM
aeropelican-air-services - OT
aeropostal - VH
aerorepublica - P5
aerostar - AS2
aerosur - 5L
aerosvit-airlines - VV
africa-airways - VJ
afriqiyah-airways - 8U
aigle-azur - ZI
air-algerie - AH
air-alliance - ZX
air-alps-aviation - A6
air-antilles-express - 3S
air-arabia - G9
air-arabia-egypt - E5
air-arabia-maroc - 3O
air-astana - KC
air-austral - UU
air-azul - ZQ
air-bagan - W9
air-baltic - BT
air-berlin - AB
air-bishkek - KR
air-botswana - BP
air-burkina - 2J
air-busan - BX
air-canada - AC
air-caraibes - TX
air-china - CA
air-comet - A7
air-dolomiti - EN
air-dominicana - ED
air-ecuador-airecu - N5
air-europa - UX
air-france - AF
air-greco - WV
air-greenland - GL
air-italy - I9
air-ivoire - VU
air-jamaica - JM
air-labrador - WJ
air-link - DR
air-macau - NX
air-madagascar - MD
air-malawi - QM
air-malta - KM
air-marshall-islands - CW
air-mascareignes - MV
air-mauritius - MK
air-moldova - 9U
air-namibia - SW
air-new-zealand - NZ
air-nippon - EL
air-niugini - PX
air-one - AP
air-one-cityliner - CT
air-pacific - FJ
air-paradise - PT
air-philippines - 2P
air-saint-pierre - PJ
air-senegal-intl - V7
air-service - X7
air-seychelles - HM
air-sinai - 4D
air-southwest - 08
air-sylhet-ag - SL
air-tahiti - VT
air-tahiti-nui - TN
air-tanzania - TC
air-taxi-europe - TZ
air-transat - TS
air-uganda - U7
air-vallee - DO
air-vanuatu - NF
air-zimbabwe - UM
airasia - AK
airasia-x - D7
aircalin - SB
aircompany-khors - KO
airkenya-aviation - QP
airlinair - A5
airline-utair-ukraine - QU
airlines-png - CG
airnorth-regional - TL
airtran-airways - FL
al-naser-airlines - 6N
al-khayala - XY
aladia-airlines - 9A
alaska-airlines - AS
albanian-airlines - LV
alitalia - AZ
alitalia-express - XM
all-nippon-airways - NH
alma-de-mexico - C4
almasria-universal-airlines - UJ
aloha-airlines - AQ
alpine-air - N6
als-ltd - K4
amadeus-pdf-2y - 2Y
amber-air - 0A
american-airlines - AA
american-connection - AX
amsterdam-airlines-bv - WD
andes-lineas-aereas - OY
antrak-air - O4
arik-air - W3
arik-niger - Q9
arkefly - OR
arkia - IZ
armavia - U8
aserca - R7
asian-air - KJ
asiana-airlines - OZ
asky - KP
ata-airlines - TZ0
athens-airways - ZF
atlant-soyuz - 7B
atlantic-airways - RC
atlantis-european-airway - TD
atlasglobal - KK
atlasjet - KK2
atyrau-aue-joly - IP
aurigny-air-services - GR
austral-lineas-aereas - AU
austrian - OS
avia-traffic-company - Z7
aviacsa - 6A
avianca - AV
avianova-lcc - AO
aviateca - GU
aviation-starlink - Q4
avion-express - X9
avitrans-nordic - 2Q
axis-international-lines - O8
azerbaijan-airlines - J2
azul-linhas-aereas-brasileiras - AD
bh-airlines - JA
bahamasair - UP
bangkok-airways - PG
barents-airlink - 8N
bearskin-airlines - JV
bek-air - Z9
belair-airlines - 4T
belavia - B2
bellview-airlines - B3
benin-golf-air - A8
berjaya-air - J8
biman-bangladesh-airlines - BG
binter-canarias - NT
bird-information-systems - 1R
bismillah-airlines - 5Z
blekinge-flyg - 2Q3
blu-express - BV1
blue-air - 0B
blue-islands - SI
blue-panorama-airlines - BV
blue1 - KF
bmi - BD
bmibaby - WW
boutique-air - 4B
brindabella-airlines - FQ
bringer-air-cargo - E6
brit-air - DB
british-airways - BA
brussels-airlines - SN
bukovyna-airlines - BQ
bulgaria-air - FB
business-air - 8B
calm-air-international - MO
camair-co - QC
cambodia-angkor-air - K6
cameroon-airlines - UY
canadian-north - 5T
cape-air - 9K
carib-aviation-limited - 3Q
caribbean-airlines - BW
carpatair - V3
caspian-airlines - RV
cathay-pacific - CX
cayman-airways - KX
ccm-airlines - XK
cebu-air - 5J
central-mountain-air - 9M
centralwings - C0
centre-avia-airlines - J7
chalair - CE
china-airlines - CI
china-eastern-airlines - MU
china-southern-airlines - CZ
chu-kong-passenger-transport - 3A
cimber-sterling - QI
cirrus-airlines - C9
city-airline - CF
cityjet - WX
clickair - XG
comair - MN
comores-aviation-international - O5
condor - DE
continental-airlines - CO
continental-airways - PC1
conviasa - V0
copa-airlines - CM
corsair - SS
croatia-airlines - OU
cubana-de-aviacion - CU
cyprus-airways - CY
czech-airlines - OK
czech-connect-airlines - CQ
daallo-airlines - D3
dagestan-airlines - N2
dalavia - H8
dana-airlines - 9J
danish-air-transport - DX
danu-oro-transportas - R6
darwin-airline - 0D
darwin-airlines-sa - F7
dba - DI
default - TRIPFOR
delta-air-lines - DL
dnieproavia - Z6
domodedovo-airlines - E3
donbassaero-airlines - 7D
dragonair - KA
dutch-antilles-express - 9H
e-savtravel - L1
east-african-safari-air - B5
eastar-jet - ZE
eastern-airways - T3
easyjet - U2
edelweiss-air - WK
egyptair - MS
el-al-israel-airlines - LY
el-sol-de-america - 6S
elysian-airlines - E4
emirates - EK
eos-airlines - E0
eritrean-airlines - B8
estonian-air - OV
ethiopian-airlines - ET
etihad-airways - EY
eurofly - GJ
euroline - 4L
euromanx - 3W
eurostar - 9F
eva-air - BR
express-rail-link - 5Y
expressjet-airlines - XE
falcon-air - IH
far-eastern-air-transport - EF
felix-airways - FO
finnair - AY
finncomm-airlines - FC
first-air - 7F
five-fourty-aviation - 5H
flexflight - W2
fly-lappeenranta - 3B2
fly-smaland - 2Q10
flybaboo - F70
flybe - BE
flydubai - FZ
flyglobespan - Y2
flylal - TE
flynordic - LF
freedom-air - SJ0
frontier-airlines - F9
fuji-dream-airlines - JH
gabon-airlines - GY
garuda-indonesia - GA
gb-airways - GT
georgian-airways - A9
germania - ST
germanwings - 4U
ghana-intl-airlines - G0
girjet - 8G
globus-llc - GH
gmg-airlines - Z5
gol - G31
golden-air - DC
gotlands-flyg - 2Q4
great-lakes-aviation - ZK
gryphon-airline - 6P
gulf-air - GF
gulfstream-international - 3M
hahn-air - HR
hainan-airlines - HU
halcyon-air-cabo-verde - 7Z
hamburg-international - 4R
hamsal-air-services - 2H
hapagfly - HF
harbour-air-seaplanes - H3
harmony-airways - HQ
hawaiian-airlines - HA
hawkair - BH
heli-air-monaco - YO
heli-securite - H4
helicopteros-del-sureste - UV
helijet-international - JB
helitrans-as - 9I
hellenic-imperial-airways - HT
helvetic-airways - 2L
hemus-air - DU
hennan-airlines - VD
hewa-bora-airways - EO
hex-air - UD
hi-fly-transportes-aereo - 5K
hong-kong-airlines - HX
hong-kong-express-airways - UO
iberia - IB
iceland-express - HW0
icelandair - FI
imair-airline - IK
indigo - 6E
indochina-airlines - IO
indochina-airlines - VP
indonesia-air-transport - I8
insel-air-international - 7I
inter-air - D6
interavia-airlines - ZA
intercontinental-de-aviacion - RS2
interjet - 4O1
intersky-luftfahrt - 3L
iran-air - IR
island-air - WP
islas-airways - IF
israir-airlines - 6H
istanbul - SK3
italia-tour-airlines - OI
itek-air - GI
jalways - JO
japan-airlines - JL
japan-asia-airways - EG
jat-airways - JU
jazeera-airways - J9
jet-airways - 9W
jet-for-you - J4
jet-lite - S2
jet2com - LS
jet4youcom - 8J
jetairfly - TB
jetblue - B6
jetlink-express - J0
jetstar - JQ
jetstar-asia - 3K
jetstar-pacific-airlines - BL
jin-air - LJ
job-air - 3B
joy-air - JR
jsc-airline-taimyr - Y7
jsc-aviaprad - WR
jsc-donavia - D9
jsc-nordavia - 5N
jsc-semeyavia - E8
kabo-airlines - N9
karthago-airlines - 5R
kartika-airlines - 3Y
kavminvodyavia-airlines - KV
kd-air - XC
kd-avia - KD
kenmore-air - M5
kenya-airways - KQ
kingfisher-airlines - IT
klm-cityhopper - WA
klm-royal-dutch-airlines - KL
kogalymavia-airlines - 7K
korean-air - KE
kuban-airlines - GW
kululacom - MN0
kunming-airlines - KY
kuwait-airways - KU
kyrgyzstan-air-company - QH
lavion - A0
lacsa - LR
lagun-air - N7
lam-mozambique - TM
lan-airlines - LA
lanargentina - 4M
lanecuador-aerolane-sa - XL
lanperu - LP
lao-airlines - QV
lauda-air - NG
lc-busre - W4
lgw-luftfahrtges-walter - HE
liat - LI
libyan-airlines - LN
livingston - LM
lot-polish-airlines - LO
ltu-intl-airways - LT
lufthansa - LH
lufttransport-as - L5
luxair - LG
lviv-airlines - 5V
lynx-aviation - L3
macair-airlines - CC
macair-jet-sa - VM
macedonian-airlines - IN
mahan-airlines - W5
malaysia-airlines - MH
malev-hungarian-airlines - MA
malmo-aviation - TF
mandarin-airlines - AE
mango - JE0
mars-rk - 6V
martinair - MP
mauritania-airways - YD
max-aviation - L4
maya-island-air - MY
mayair - 7M
mdlr-airlines - 9Y
meridiana - IG
mesa-airlines - YV
mexicana - MX
mexicana-link - I6
miat-mongolian-airlines - OM
middle-east-airlines - ME
midwest-airlines - YX
mokulele-flight-service - MW
moldavian-airlines - 2M
monarch-airlines - ZB
montenegro-airlines - YM
montserrat-airways - 5M
moskovia-airlines-jsc - 3R
motor-sich-jsc - M9
multi-aero - 3E
munich-airlines - I2
myaircom - 8I
myanmar-airways-intl - 8M
nacil-air-india - AI
nacil-indian-airline - IC
national-airways-cameroon - 9O
national-jet-systems - NC
new-axis-airways - 9X
nextjet - 2N
nice-helicopteres - JX
niki - HG
nile-air - NP
north-american-airlines - NA
north-flying-as - M3
north-wright-air - HW
northwest-airlines - NW
northwestern-air-lease - J3
norwegian-air-shuttle - DY
nouvelair - BJ
nova-airlines - O9
olt-ostfriesische-lufttr - OL
olympic-air - OA
olympic-airlines - OP
oman-air - WY
onetime-airline - T6
operador-aereo-andalus - EA
orenair - R2
oriental-air-bridge - OC
ostersunds-flyg - 2Q12
our-airline - ON
ozjet - O7
pacific-coastal-airlines - 8P
pacific-wings - LW
pamir-air - PM
pantanal-linhas-aereas - P8
paramount-airways - I7
passaredo - P3
pegasus-airlines - PC
pegasus-airlines2 - H9
penair - KS
peruvian-air-lines - P9
philippine-airlines - PR
phoebus-apollo-aviation - PE
pinnacle-airlines - 9E
pluna - PU
pm-air-llc - Z3
pmt-air - U4
polet-airlines - YQ
precision-air - PW
primera-air - GX
private-wings - 8W
pt-indonesia-airasia - QZ
pt-sriwijaya-air - SJ
qantas-airways - QF
qatar-airways - QR
qazaq-air - IQ
quantum-air - QO
raileasy - 01
rak-airways - RT
regional - YS
regional-air-lines - FN
regional-express - ZL
regionsair - 3C
rossiya-russian-airlines - FV
royal-air-maroc - AT
royal-brunei - BI
royal-daisy-airlines - 6D
royal-falcon - RL
royal-jordanian - RJ
royal-nepal-airlines - RA
rusline - 7R
rutas-aereas-de-venezuela-rav - AW
rwandair-express - WB
ryanair - FR
s7-airlines - S7
sam - MM
santa-barbara-airlines - S3
sas-norway - BU
sat-airlines - HZ
sata-air-acores - SP
sata-international - S4
saudi-arabian-airlines - SV
sayakhat-airlines - W7
scandinavian-airlines - SK
scat-airlines - DV
scenic-airlines - YR
scotairways - CB
senegal-airlines - DN
sevenair - UG
severstal-aircompany - D2
sham-wings-airlines - 6Q
shanghai-airlines - FM
sharp-aviation - SH
shenzhen-airlines - ZH
shuttle-america - S5
siem-reap-airways-intl - FT
silkair - MI
singapore-airlines - SQ
skippers-aviation - JW
sky-airline - H2
sky-airlines - ZY
sky-express - XW
sky-georgia - QB
sky-jet-aviation - UQ
skybahamas-airlines - Q7
skynet-asia-airways - LQ
skyservice-airlines - 5G
skytrans-regional - Q6
skyways-ab - JZ
skywest-airlines - XR
slok-air-international - S0
smart-wings - QS
smartlynx-airlines - 6Y
sn-air-mali - I5
solomon-airlines - IE
somon-air - 4J
somon-air - SZ
south-african-airways - SA
south-airlines - YG
south-east-european-air - G2
spanair - JK
spicejet - SG
spirit-airlines - NK
spirit-of-manila-airlines - SM
srilankan-airlines - UL
star-airways - 4S
star1-airlines - V9
start - 1T
sterling - NB
sudan-airways - SD
sun-country - SY
sun-dor-intl-airlines - 2U
sun-express - XQ
sunday-airlines - DV2
sundsvalls-flyg - 2Q8
surinam-airways - PY
svenska-direktflyg-ab - HS
swiss - LX
sylt-air-gmbh - 7E
syrian-arab-airlines - RB
taag - DT
taca-intl-airlines - TA
taca-peru - T0
tacv-cabo-verde-airlines - VR
tajik-air - 7J
tam-air - L6
tam-linhas-aereas - JJ
tam-mercosur - PZ
tap-portugal - TP
tarom - RO
tatarstan-air - U9
tci-skyking-ltd - RU
thai-airasia - FD
thai-airways-intl - TG
thomas-cook-airlines - MT
thomsonfly - BY
tianjin-airlines - GS
tibet-airlines - TV
toumai-air-tchad - 9D
trans-air-congo - Q8
transaero-airlines - UN
transasia-airways - GE
transavia-airlines - HV
transavia-denmark - PH
tuifly - X3
tuifly-nordic - 6B
tulca - JE
tulpar-avia-service - R4
tunisair - TU
turkish-airlines - TK
twin-jet - T7
tyrolean-airways - VO
ukraine-intl-airlines - PS
um-air - UF
united-airlines - UA
ural-airlines - U6
us-airways - US
us-helicopter-corp - UH
usa-3000 - U5
utair-aviation-jsc - UT
uzbekistan-airways - HY
v-australia - VA
valuair - VF
vietnam-airlines - VN
viking-hellas-airlines - VQ
vim-airlines - NN
vip-wings - V5
virgin-atlantic - VS
virgin-australia - DJ
virgin-nigeria - VK
vision-airlines - V2
viva-aerobus - VB1
vladivostok-air - XF
vlm-airlines - VG
volare-spa - VE
vrg-linhas-aereas - G3
vrg-linhas-aereas-sa - RG
vueling-airlines - VY
wataniya-airways - KW
welcome-air - 2W
west-coast-air - 8O
westjet - WS
wideroe - WF
wind-jet - IV
wind-rose-aviation - 7W
windward-island-airways - WM
wings-of-bornholm - 2Q11
wizz-air - W6
xl-airways-france - SE
xtra-airways - XP
yakutia-air-company - R3
yamal-airlines - YC
yangon-airways - YH
yellow-airtaxi - Y0
yemenia-yemen-airways - IY
zambezi-airlines - ZJ
zambia-skyways - K8
zestair - Z2
победа - DP
